0000000000
000000*000
0***000000
0000000000
0000*****0
0000000000
00**000000
00**000000
00**000000
0000000000